00006990000000000000000000000000000
00000960000000000990000000000000000
00000990000000000990000000000000000
00000000000000990999990000000000000
00000000000009969966699000000000000
00000000000000000000000000000000000
00000000000000000000000000000000000
00000000000000000000000000000000000
00000000000000000000000000000000000
00000000000000909000000000000000000
00000000000009669000000000000000000
00000000000006699999900000000000000
00000000000066999660000000000000000
00000000000006999000000000000000000
00000000000000999000000000000000000
00000000000000999000000000000000000
00000000000000000000000000000000000
00000000000000000000000000000000000
00000000000000000000000000000000000
00000000000000000000000000000000000
00000000000000000000000000000000000
00000000000000000000000000000000000
00000000000000000000000000000000000
00000000000000000000000000000000000
00000000000000000000000000000000000
00000000000000000000000000000000000
00000000000000699900000000000000000
00000000000099996000000000000000000
00000000000069996900000000000000000
00000000000099999000000000000000000
00000000000009900000000000000066900
00000000000009000000000000000066900
00000000000000000000000000000000900
00000000000000000000000000000000000
00000000000000000000000000000000060